1111111111111111111111111111111
10010000000000000000000000000C1
10000P0000000C000000000000000C1
100000000000C000000000000000C01
100000000000C000000000000000C01
100000000000C000000000000000C01
100000000000C000000000000000C01
10011E000C0C000000000000000C0C1
1111111111111111111111111111111