1111111111111
10010000000C1
1000000C00001
1000100000C01
1000000000C01
1P0011E000C01
1111111111111