11111111
10P00E01
100001C1
11111111