11111111
10P01E11
100001C1
11111111